screenplay - сценарий
popsicle - эскимо
hull - корпус, каркас
sank - затонуть
scrape - скрести, задевать, подходить вплотную
establish - учредить
nomads - кочевники
wealth - богаство 
porch - порог, крыльцо, терраса
hemisphere - полушарие
A.D. - наша эра
shawl - шаль
peers - сверстники
soothing - успокаивающий
comparable - сопоставимый
starring - в главных ролях
conveniently - удобно
convenient - удобный
appoint - назначать
ownership - собственность
significance - важность
presence - присутствие, явка
absence - отсутствие
persistence - упорство
live expectancy - продолжительность жизни
fluency - беглость, плавность
accuracy - точность
literacy - грамотность
significant - значимый, существенный
respectively - соответственно
derived - полученный
reluctant - вынужденый, неохотный
magnificent - великолепный
ignorance - невежество
treatment - лечение
acceptance - принятие, признание
awareness - осведомленность
disappearance - исчезновение
invention - изобретение
handbag - сумочка
reliable - надежный
cottage cheese - творог
reduction - снижение
settlement - заселение, поселение
extinction - исчезновение, вымирание
endangered - находящиеся под угрозой вымирания
species - виды, разновидности
to provide - предоставлять
whale - кит
unemployment - безработица
misprint - опечатка
disarmament - разоружение
uneasiness - беспокойство
mother_in_law - свекровь
commander_in_chief - главнокомандующий
herd - стадо
wool - шерсть
parlor - гостиная, салон, общая комната
servant - слуга
to insist(on) - настаивать
altar - алтарь
cloth - ткань, скатерть
briefcase - портфель
marble - мрамор
to nod - кивать
oratory - часовня
